OOOUOOOO
O      O
U  X   U
O      O
OOOUOOOO